=============================
=    X          *     K   #@=
=!      *  *              ##=
=    M          ^     %     =
==========#==================
= T F            X *W*      =
=***               ***      =
=%!*      ^       %         =
=============================