=============================
=    X          *      K # @=
=!      *  *              ##=
=               ^     %     =
==#=====#====================
= T F            X  W       =
=***                *   M   =
=!*    % ^                  =
=============================