=============================
= !  *                  #  @=
=               %       =====
=  % *        ^         #   =
=                       #   =
=************************ **=
=X                          =
=***************************=
=============================
=X                          =
=          ^               X=
=*****             %        =
=*****===#==      ===========
=*****=W  F=      = X      %=
= K   =T  M=  ^   =      !  =
=============================